..###################################################################################################
..#.........#.....#.....#.....#...........#...#.....#.......#.#...#.....#.....#.#.#.....#.#.#.......#
#.#.###.###.###.#.###.#.#####.###.#.###.###.#.#.#.###.###.###.###.#.###.#.#####.#.#.###.#.#.#.#######
#...#.....#.#...#.....#...#.......#...#.#.#.#...#...#.#.....#...#.....#.#.#.....#.#.#.........#.....#
#####.#.###.###.#.#######.#.#####.#######.###.#.#####.#.#.#.#.#######.###.#.#.#.#.###.#########.###.#
#.#.#.#.#.......#.#...#.#.#.#.#.#.........#...#.....#.#.#.#.....#.#...#...#.#.#.................#.#.#
#.#.#####.#.#########.#.#.#.#.#.#.#########.#####.#.#.#.#########.#.#####.#.#####.#.#####.#####.#.###
#...#.....#.....#.......#...#...#.#...#.#.#.#.#...#.#.#.#...#.......#.#.....#.#.#.#.....#...#.......#
#.#############.#.#.#########.###.#.#.#.#.###.###.#.#.###.#########.#.#######.#.#.#.#####.#.###.#.#.#
#.#...#.....#.#...#.#.#.......#.....#.......#.#...#.#.................#...#.#.....#.....#.#.#.#.#.#.#
#.###.#.###.#.#######.#.###.#####.###.###.###.#.#.#.###.###.###.#.#######.#.#.#.#.#.###.###.#.#.#.#.#
#.....#...#.#...#.#.......#...#...#.....#...#.#.#.#.#.#.#.....#.#.#.#...#.....#.#.#.#.#...#...#.#.#.#
###.#.#.#######.#.###.#####.#.###.###.#######.###.#.#.#.#######.###.#.#######.###.###.#.#######.#####
#...#...#.........#...#...#.#.....#.#.....#.#.#...#.#.#.#.....#.......#.....#.#.....#.#.#...........#
#.###.#.#.#.#####.#######.#.#######.#.###.#.#.#.#.###.#.#.#############.#.###.#######.#.###.#.#.#.#.#
#.#...#.#.#.#...#.#...#...#.#...........#.#.#...#.......#...........#.#.#.........#.....#.#.#.#.#.#.#
#######.###.#.#######.#.#.#.#######.###.#.#.###########.#.#####.#####.###.#######.#####.#.###.#######
#.#.....#.#...#.#.......#.#.#.#.#.#...#.#.....#.....#...#...#.#.....#.#.......#.#...#.....#.....#...#
#.#.#####.#.###.###.#######.#.#.#.#.#######.#.#.#.###.###.###.###.###.###.#####.###########.#######.#
#.....#.#.#.#...............#...#.#...#...#.#.#.#...#...#...#...............#.#.....#.....#.#...#...#
###.#.#.#.#.#.###.#####.###.#.#.#.#####.#####.###.#####.#########.###.#####.#.###.#.###.#######.#.###
#...#.#...#...#.#...#.....#...#...#.#.....#...#.#...........#...#.#...#...........#...#.....#...#.#.#
#.#####.#####.#.#.#.#######.###.###.#####.###.#.#.###.#######.#.###.#######.#.#.#.#.###.###.#.###.#.#
#.....#.......#.#.#...#...#.#...#.#.#...#.#.#.......#.#...#...#.#...#.......#.#.#.#...#...#.#.......#
#.###.#####.#.#.###.#####.#.###.#.#.###.#.#.###.###.###.#####.#.###########.#########.#.#####.#####.#
#.#.......#.#.#.........#...#.#.#.......#.......#.....#.....#.#...#...........#.#.#.....#.......#.#.#
###.#.#####.#.#.###.#.###.###.#####.###.#####.#############.###.###.#.#.#.#####.#.###.#.###.#####.#.#
#...#.......#.#...#.#.#.........#.....#.........#.......#...........#.#.#.#...#.#.....#.......#.....#
#.#####.###########.#.#########.#############.#.#.###.###.###.#.###.###.#.#.#.#.###.#####.#######.###
#.#.#.#.#...#.#.....#.#.......#.#...........#.#.#...#.#...#...#.#.#...#.#...#...#...#.......#...#.#.#
#.#.#.###.#.#.#####.###.###.###.###.#####.#.###.#.#####.#######.#.#.#.#.#########.#.###.###.#.#.#.#.#
#.......#.#.........#...#...#.....#.#.....#.#.............#...#.#.#.#.#.#.....#.#.#...#.#...#.#.#...#
###.#.###.###.###.###.###.#####.#.#####.#########.#####.###.#####.#.#######.###.#####.#########.#.###
#.#.#.#...#.....#.....#.....#...#...#.....#.#.#.....#...#...#.......#.#.#.#...#.#...#.#.#.#.#.....#.#
#.###.#.#######.#.#.#.#.#####.#.###.#.#####.#.###.#.###.#.###.#######.#.#.#.###.###.#.#.#.#.#.###.#.#
#...#.#.#...#...#.#.#.#...#...#.#.#.#.....#.#.#.#.#.#...#.....#...#.#.....#.....#.#...#.....#.#...#.#
###.###.#.#.###.#######.###.#.#.#.#.#.###.#.#.#.###.#######.#.#.###.#.#.#####.#.#.#####.#.#.#######.#
#.........#.#.....#.#.....#.#.#...#.#.#.....#.#.#...#...#...#.....#.#.#.#...#.#.#.......#.#.#...#...#
#.#.#####.###.#####.#.###.###########.###.#.#.#.#####.#.#.#.#######.###.#.#.#.#####.#.#.###.###.#.#.#
#.#.#.#...#.#.....#...#.......#.#.....#...#.#.....#...#.#.#...#.#.#...#...#...#.#...#.#.#.......#.#.#
#.###.#.###.#########.#######.#.#.###.###.#######.#####.#.#.###.#.###.#####.#.#.###.###.#####.#####.#
#.#.......#.....#.....#...#.#.#...#...#.#...#...#.....#...#.....#.#.#.......#.#.....#.#.....#.....#.#
#######.#######.#####.#.#.#.#.#######.#.###.###.#.#####.#######.#.#.#.#######.#.#.#.#.#.###.#.###.#.#
#.#...#...#.#...#.#.#...#.#.........#.#.....#...#...#.#...#...#.#...#...#.......#.#...#...#.#...#...#
#.###.#.###.###.#.#.###########.#########.#.#.#.###.#.#.#####.#####.###.#######.#####.#########.#.###
#.........#...#.#.....#.....#.....#.#.#.#.#.#.#.#...............#.#.....#.#.....#...#...#.....#.#.#.#
#.###.#.#####.#.#.#.#.#.###.#.###.#.#.#.#.#####.#.#####.#######.#.###.###.#######.#####.#.#.#.###.#.#
#.#.#.#.#.......#.#.#.#.#.#.....#.#...#.......#.#...#.........#.....#.....#.......#.....#.#.#.......#
###.#.#######.###.###.#.#.###.###.###.#.#####.#.#######.#.#######.#.#.###.###.###.#######.#####.#.###
#.......#.....#...#...#.#.#...#.......#...#.......#.#.#.#.#.....#.#.#.#.#.#.#.#.......#...#...#.#...#
#.#########.#.###.#####.#.###.###.#.###.###########.#.#.#####.#####.#.#.###.#.#######.#.#.#.###.#####
#.#.....#...#.#.......#.#.....#...#.........#.........#.......#.....#.......#.....#.....#.#.#.#.#...#
#.#####.#.#####.#.###.#######.#######.#########.###.#.#.#.#####.#.#.#########.#######.#.###.#.###.###
#.......#...#.#.#.#.#.#.#.#...#...#.#...#.#.......#.#...#...#...#.#.#.#...#...#.......#.....#.....#.#
#.#.#.#.#.###.#.###.###.#.###.###.#.###.#.#####.#######.#.###########.#.#####.###.###.#.###.#.###.#.#
#.#.#.#...#...#.......#.#.....#.#.....#.#.....#.......#.#.#.#...#...#.....#...#.....#.#.#...#...#.#.#
#.###.#####.#########.#.#.#.#.#.#####.#######.#######.#####.#.#.###.###.#########.###.#.###.#.#####.#
#...#.#.......#...#.....#.#.#.#.#...........#.....#.....#.....#.....#.#.......#.#...#.#.#.#...#...#.#
#.###########.#.#.#####.###.###.#.#########.#.#.#.###.#.#######.###.#.###.#####.###.#####.###.#.#.#.#
#.#.....#.#.....#.#.#.#.....#.......#...#.#...#.#.#...#...#.......#.#.....#.....#.......#...#.#.#...#
###.###.#.#.#######.#.#.#####.###.###.###.#.#######.#.#.#########.###.#######.#.#.#.#####.###.#.#####
#...#.....#.......#.#...#...#...#...#.#...#...#...#.#.#.#.#.#...........#...#.#.#.#.#.......#...#.#.#
#######.#####.#####.#.#.#.###.#.#.###.###.###.#.#######.#.#.#####.#.#.###.###.#####.#.#.###.#####.#.#
#.......#.#.#.........#.....#.#.#...#.#...#.#...#.....#.........#.#.#.........#.#.#...#.#.........#.#
###.###.#.#.#.#.#########.#####.#####.###.#.#.#####.#.#.#######.#####.#####.#.#.#.###.###.#####.###.#
#.....#.#.....#...#.....#.#...#...#...#.....#.#.....#.#.....#...#.#...#.#...#.#.#.#.#.#.#.....#.....#
#.###.#####.###.#.###.#.#.###.#.###.#######.#.#.#####.#.#.#.#.#.#.#.#.#.#######.#.#.#.#.#######.#####
#.#...........#.#.....#.#.#.#.#.#.#.......#.......#.....#.#.#.#.....#.......#.....#.#.#.#.....#.....#
#.#########.#.#.#######.###.#.#.#.#####.#####.#.#####.###.###.#.#####.#####.#.#.###.#.#.###.#####.###
#...#...#.#.#.#...#...#.#...#...........#...#.#.....#.#.....#.#.#.....#...#.#.#.#.......#...#...#...#
#.#####.#.#.#.###.#.#####.###.###########.###.#.#.###########.#.#####.###.###.###.#.#####.#####.#.#.#
#.#.....#...#.#.....#.........#.#.#.....#.#...#.#.#.#...#...#.#.#.......#...#.....#.....#.....#...#.#
#####.#########.#.#####.#.#.###.#.###.#.#.#######.#.###.###.#.###.###.#####.#.###.###.#######.###.###
#...........#...#.#.....#.#.#...#.#.#.#.#.....#.#...#.#.....#.#.....#.#.#.#.#...#.#...#.#.......#...#
###.#.#####.#.#.###.###########.#.#.###.###.#.#.#.#.#.#.#.###########.#.#.#.#.###.#####.#.#####.#####
#.#.#.#...#...#.#.....#.......#.............#.#...#...#.#...#.#.....#...#.....#.......#...#...#.....#
#.###.#.#######.###.#####.#.#.###.###.###.###########.#.#####.#.#.###.#.#.#####.#.#.#.#.#.#.#####.#.#
#...........#.#...#.#.....#.#.#...#.#.#.....#.#.......#.#.....#.#.#.#.#...#...#.#.#.#.#.#...#.#...#.#
###########.#.#.###.#.###.#.#.###.#.#####.#.#.#######.#.#####.#.###.###.#.#.#####.###.###.#.#.#.###.#
#.#.....#.#.#...#.....#...#.#.#.#.#.......#...#.#...#.........#.........#.....#...#.....#.#...#.#...#
#.#####.#.#######.#############.#######.#######.#.#######.#####.###.###.#.#######.#.#.#.#.#####.#.###
#.........#...#.#.#.......#.#.#.....#.#...#.#.#...#...#...#.....#.#...#.#.#.....#.#.#.#...#...#.#...#
#####.#####.#.#.#.#.#.#####.#.###.###.###.#.#.###.###.#####.#####.#.#.#####.#.###.#########.#.#.#####
#...#.#...#.#.#.#.#.#.#.....#...#.....#.....#.......#.......#.#.....#.....#.#.#.#.......#...#.......#
###.#.###.#.###.#.#.###.#####.###.###.#.#####.###.#########.#.#.#.#####.###.#.#.#####.#############.#
#.......#...............#.......#...#.#...#...#.#.#.#.#.....#.#.#.#.....#...#...#.#.#.#.........#...#
#######.###.#########.###.###.#.#.#######.#.#.#.###.#.#######.#########.###.###.#.#.###.#########.###
#.............#.#.#.#.....#...#...#.#.#...#.#.#.#.......#.#.........#...#...#.......#...#...#...#...#
###.###.#.#####.#.#.#####.#####.#.#.#.###.#.###.#######.#.#.#######.###.#.#.#########.###.#####.#####
#.....#.#.#.#.......#...#...#...#.....#.....#.#.#.........#.......#.#.....#.#.......#...........#.#.#
###.#####.#.#####.#.#.#.#.#.###.#####.#.#####.#.#####.###.###.#.###.#.###.#.#######.###.#######.#.#.#
#.......#.#.#...#.#.#.#...#.#.....#...#...........#.....#...#.#.#.#.#.#...#...#...........#.......#.#
###.#####.#.###.###.#.#########.#.#.###.###.#########.###.###.###.#.#.###.#######.###.#########.#.#.#
#...#.......#...............#.#.#.#.....#.......#...#.#.#...#.#.#...#.#.#.#...#.....#.#...#.....#.#.#
#.#.#.#########.#####.#.#####.#.#######.###.#######.#.#.#####.#.#######.#.#.#####.#.#####.#.#.#.###.#
#.#.#...#...#.....#...#.....#...#.#.....#.#.....#.#...#...#.......#.......#.......#.#.......#.#.#...#
#.#########.#.#.#.#########.#.#.#.#.#.#.#.#.#####.#.###.#######.#######.#.###.#######.###.#######.#.#
#.......#...#.#.#...#.....#.#.#.#...#.#.#.....#.#...#.#.#.......#.....#.#.....#.#...#.#.#.........#.#
#.###.#.#.#.###.#.#.###.#.#.#.###.#.#.#######.#.#.###.#.#.#.#.###.###.#.#####.#.#.###.#.#####.#.###.#
#.#...#...#.#...#.#.....#.#.#.#...#.#...#.............#...#.#.....#.....#.......#.....#.......#...#..
###################################################################################################..