#A###################
#...#...#...#.......#
#.#####.#.#########.#
#...#.....#.#.#.....#
#.#####.#.#.#.###.#.#
#.#.....#.#.......#.#
#.#####.###.#####.#.#
#.......#...#...#.#.#
#.###.#.#.#.#.#####.#
#...#.#...#.#.#.#...#
###.#.#####.#.#.###.#
#...#.#...#.#...#...#
#######.#.#.###.#.###
#.#.....#.....#.#...#
#.###.#.#####.#.###.#
#...#.#...#...#.#.#.#
#.#######.#.#.#.#.#.#
#...#.#.#.#.#...#...#
###.#.#.#.#####.#.###
#.............#.#...B
#####################